{
	"leftGrid":[
		1,0,0,0,0,2,0,0,0,
		0,1,0,0,0,2,0,0,0,
		0,0,1,0,0,2,0,0,0,
		0,0,0,1,0,2,0,0,0,
		0,0,0,0,1,2,0,0,0,
		0,0,0,0,0,0,0,0,0,
		0,0,0,0,0,0,0,0,0,
		0,0,0,0,0,0,0,0,0,
		0,0,0,0,0,0,0,0,0,
		0,0,0,0,0,0,0,0,0,
		0,0,0,0,0,0,0,0,0
	],
	"rightGrid":[
		0,0,0,0,0,2,0,0,0,
		0,0,0,0,0,2,0,0,0,
		0,0,0,0,0,2,0,0,0,
		0,0,0,0,0,2,0,0,0,
		0,0,0,0,0,2,0,0,0,
		0,0,0,0,0,2,0,0,0,
		0,0,0,0,1,2,0,0,0,
		0,0,0,1,0,0,0,0,0,
		0,0,1,0,0,0,0,0,0,
		0,1,0,0,0,0,0,0,0,
		1,0,0,0,0,0,0,0,0
	],
	"time": 300
}