{
	"leftGrid":[
		1,1,1,1,1,1,1,1,1,
		4,1,0,0,0,2,0,0,2,
		4,0,1,0,0,2,0,0,2,
		4,0,0,1,0,2,0,0,2,
		4,0,0,0,1,2,0,0,2,
		4,0,0,0,0,0,0,0,2,
		4,5,5,5,5,5,5,0,2,
		4,0,0,0,0,0,0,0,2,
		4,6,6,6,6,6,6,0,2,
		4,0,0,0,0,0,0,0,2,
		4,3,3,3,3,3,3,3,3
	],
	"rightGrid":[
		0,0,0,0,0,2,0,0,0,
		0,0,0,0,0,2,0,0,0,
		0,0,0,0,0,2,0,0,0,
		0,0,0,0,0,2,0,0,0,
		0,0,0,0,0,2,0,0,0,
		0,0,0,0,0,2,0,0,0,
		0,0,0,0,1,2,0,0,0,
		0,0,0,1,0,0,0,0,0,
		0,0,1,0,0,0,0,0,0,
		0,1,0,0,0,0,0,0,0,
		1,0,0,0,0,0,0,0,0
	],
	"time": 300
}